GWM = "countries/Weimar Republic.txt"
WHI = "countries/Zhi Xi.txt"
YIN = "countries/Qian Xi.txt"
FEN = "countries/Feng Xi.txt"
CXC = "countries/Chuan Xi.txt"
WAN = "countries/Wan Xi.txt"
WUH = "countries/Wu Han.txt"
ZZA = "countries/Ma Lin.txt"
ZZB = "countries/Lu Hong Tao.txt"
ZZC = "countries/Chuan Bian.txt"
ZZD = "countries/Zhao Heng Ti.txt"
ZZE = "countries/Wang Yong Quan.txt"
ZZF = "countries/Chen Jiong Ming.txt"
ZZG = "countries/Deng Ben Yin.txt"
ZZH = "countries/Jing Yue You.txt"
ZZI = "countries/Liu Cun Hou.txt"
ZZJ = "countries/Zhen Song Jun.txt"
ZZK = "countries/Chen Ji Tang.txt"
ZZL = "countries/Cai Cheng Xun.txt"
ZZM = "countries/Ma Lian Jia.txt"
ZZN = "countries/Qi Xie Yuan.txt"
ZZO = "countries/Zheng Shi Qi.txt"
ZZP = "countries/Han Yu Kun.txt"
ZZQ = "countries/Feng Yu Xiang.txt"
ZZR = "countries/Song Zhe Yuan.txt"
ZZS = "countries/Yang Hu Cheng.txt"
ZZT = "countries/Ma Hu Shan.txt"
ZZU = "countries/Yao Le Bo Si.txt"
ZZV = "countries/Zhang Zhao Jia.txt"
ZZW = "countries/Li Jing Lin.txt"
ZZX = "countries/Guo Song Ling.txt"
ZZY = "countries/Xi Bei Jun.txt"
ZZZ = "countries/Tang Sheng Zhi.txt"
ZZ0 = "countries/Ga Da Mei Lin.txt"
ZZ1 = "countries/Dong Tu Jue Si Tan.txt"
ZZ2 = "countries/Ke Er Ke Zi.txt"
ZZ3 = "countries/Cha Ha Er DefJAP Alies.txt"
ZZ4 = "countries/Ma Zhan Cang.txt"
ZZ5 = "countries/He Jia Ni Ya Zi.txt"
AMR = "countries/Army Move Road.txt"
SKI = "countries/Sikkim.txt"